/--------------------------------------<
----------------------------------------
-------S--------->v---------------------
----------------------------------------
---------v----\---------------------->-^
------------------------>--\--------//--
-->-----------/------------\\------//---
----------------------------\\----//----
-----------------------------\\--//-----
--\----/-\-------^\-----^-----\--/------
----------------------------------------
\--------------------------------------^
